10000000000000000000000
01100000000000000000000
00111100000000000000000
00000110000000000000000
00000001000000000000000
00000000110000000000000
00000000001100000000000
00000000000110000000000
00000000000001100000000
00000000000000110000000
00000000000000001100000
00000000000000000111000
00000000000000000000100
00000000000000011111100
00000000000111110000000
00000001111100000000000
00011111000000000000000
01100000000000000000000
00000000000000000000000
00000000000000000000000
00000000000000000000000
00000000000000000000000
00000000000000000000000
