00001001000000100100000
00001001000000100100000
00001001000000100100000
00001001000000100001110
11101001000000100000000
00000001101111100000000
00000000000000000111110
11110000000000000000000
00011110011111000100000
00000010010001000100000
00000000010001000111110
00000010010001000000000
00000010010001000111110
11111110010001001100000
00000000011011000000000
00000000000000001100000
00000000110111000111110
11110100100001000000000
00000100100001000000000
00000100100001001011110
00000100100001001000000
00000100100001001000000
00000000000000000000000
