100000000000000000000
010000000000000000010
001000000000000000100
000100000000000001000
000010000000000010000
000001000000000100000
000000100000001000000
000000010000010000000
000000001000100000000
000000000101000000000
000000000010000000000
000000000101000000000
000000001000100000000
000000010000010000000
000000100000001000000
000001000000000100000
000010000000000010000
000100000000000001000
001000000000000000100
010000000000000000010
000000000000000000000
000000000000000000000
000000000000000000000
