000000000000000000000
000000010000000000000
000011101111000011000
000100000001100001100
001100000000010000100
001000000000001000110
011000000001001000010
010001110001000100010
010001011011000100010
010001001110000100010
010001000000001100010
010001000000001000010
011001100000001000010
001000110000110000010
001000001111100000010
001100000000000000010
000100000000000000010
000110000000000000110
000011000000000001100
000001110000000111000
000000001111111100000
000000000000000000000
000000000000000000000
