000000000000000000000000000000000000000000000001000000000000
000000000111000000001111110000000000000000000001000000000000
000001000101100000111000000000000000000000000001100000000000
000000110000111111100001100000000000111100000000100000000000
000000010000000000000010010000000011000010000000110000000000
000000010000000000000100101000000100000010000000011000000000
000000010000000000000101101100001100000010000000001100000000
000000100000000000000101100111011001110011000000000011000000
000000110000000000000100110001110011010001000000000000110000
000000011000000000000110011100000010110000100000000000000000
000000000110111100000010000110000110100000110000111111110000
000000000000000100000010000011111100011100011111000000011000
000000000000000100000001100000000000000100000000000000001000
000000000000000100000000111111111111000100000000000000001000
000000000000000100000000000000000001000010011110000000001000
000000000000000100000000000000000001110001110001000000011000
000000000000000100000000000000000000000000000001000000010000
000000000000001100000000000000000000000011111001000000010000
000000000000001000000000000000000000000010000111001000010000
000000000000001100000000000000000000000111000000001000010000
000000000000000011000000000000000001110010111000110000010000
000000000000000000100000000000000110000010001111000000010000
000000000000000000001100000000000110000001000000001000110011
000000000000000000000001110000000010000011000000000001100110
000000000000000000000000001000000001000110000000000011000100
000000000000000000000000000010000000100100000000001010000100
000000000000000000000000000000010000100100000010000010000100
000000000000000000000000000000001111100100010010001100000100
000000000000000000000000000000000110000100010010001100000100
000000000000000000000000000000000000000111110110001100001100
000000000000000000000000000000000000000000000110100000000000
000000000000000000000000000000000000000000000011100000000000